####################
#..................#
#..................#
#..#################
#....###...........#
##.................#
###.......######...#
###########........#
#.................##
#................###
#...#########...####
##..........########
###..............###
#########.........##
#.......##.........#
#........#######...#
######.............#
#.................##
#@...............###
####################