################################
#..............................#
#..............................#
#..#############################
#....###.......................#
##.............................#
###...................######...#
#######################........#
#.............................##
#............................###
#....####################...####
##......................########
###..........................###
#########.....................##
#.......##.....................#
#........####################..#
######.........................#
#.............................##
#@...........................###
################################