####################
#.....1............#
#...............?.!#
#..#################
#..................#
##....2............#
###.......######...#
######f####........#
#.............1...##
#................###
#...#########...####
##..2.......########
###..............###
#########.........##
#.......##.........#
#&.......###w###...#
######..........2..#
#.......1.........##
#@...............###
########f###########