####################
#....#........#....#
#....#........#....#
#...!#...##...#?...#
#..###...##...###..#
#........##........#
##.......##.......##
####.....##.....####
#.......####.......#
#.....########.....#
#........##........#
#####....##....#####
#...#....##....#...#
#...##........##...#
#..................#
#..................#
#######......#######
#........##........#
#@......####......&#
####################