####################
#..................#
#...............!.?#
#...#########.2.####
##..........#####..#
###...............2#
####....1.........##
##########....#..###
#...........#...###
#...............####
#1...#.##..##f######
###................#
####.....#.....2...#
#####w#####...##...#
###..........####..#
##........1.####...#
##..###########...##
#...#............###
#@.##&..........####
####################