####################
#..................#
#..................#
#...#########...####
##..........#####..#
###................#
####..............##
##########....#..###
#...........#...####
#..................#
#....#.##..#########
###................#
####.....#.........#
###########...##...#
###..........####..#
##..........####...#
##..###########...##
#...#............###
#@.##&..........####
####################